Aristotele	greco
Balzac	francese
Beethoven	tedesco
Cartesio	francese
Cesare	romano
Ciajkovskij	russo
Confucio	cinese
Copernico	polacco
Darwin	inglese/britannico
Depp	americano
Dickens	inglese/britannico
Dostoevskij	russo
Edison	americano
Einstein	ebreo/tedesco/americano
Euclide	greco
Fermi	italiano
Galilei	italiano
Gorbachev	sovietico/russo
Hawking	inglese/britannico
Hegel	tedesco
Hitler	tedesco/austriaco
Hume	scozzese/britannico
Jolie	americana
Kant	tedesco
Keplero	tedesco
Lavoisier	francese
Leibniz	tedesco
Lenin	sovietico/russo
Lennon	inglese/britannico
Lincoln	americano
Locke	inglese/britannico
Machiavelli	italiano
Marx	tedesco
Maxwell	scozzese/britannico
Mencio	cinese
Michelangelo	italiano
Mozart	tedesco/austriaco
Napoleone	francese/italiano
Newton	inglese/britannico
Omero	greco
Pascal	francese
Platone	greco
Raffaello	italiano
Rousseau	francese
Spinoza	olandese
Stalin	sovietico/georgiano
Strauss	austriaco
Tolstoj	russo
Truman	americano
Wagner	tedesco
