Adler	Wirbeltier//Kreatur/Raubvogel/Fauna/Lebewesen/Wesen/Tier/Organismus/Lebendiges/Vogel
Allosaurus	Vogel/Archosaurier/Reptil/Dinosaurier
Ameise	Wirbelloses/Fauna/Sein/Lebewesen/Tier/Organismus/Insekt
Anakonda	Schlange/Reptil/Boa
Biber	Wirbeltier/Kreatur/Fauna/Säugetier/Tier/Organismus/Nagetier
Biene	Wirbelloses/Fauna/Lebewesen/Wesen/Tier/Organismus/Insekt
Büffel	Wirbeltier/Wiederkäuer/Kreatur/Fauna/Kuh/Säugetier/Wesen/Tier/Bison/Organismus/Huftier/Rinder
Chinchilla	Wirbeltier/Kreatur/Fauna/Säugetier/Tier/Organismus/Nagetier
Eichhörnchen	Wirbeltier/Kreatur/Fauna/Säugetier/Tier/Organismus/Nagetier
Ente	Wirbeltier/Hausgeflügel/Kreatur/Fauna/Wasservögel/Lebewesen/Geflügel/Wesen/Tier/Organismus/Vogel
Eulen	Wirbeltier/Kreatur/Raubvogel/Fauna/Lebewesen/Wesen/Tier/Organismus/Vogel/Schädel
Falke	Wirbeltier/Kreatur/Raubvogel/Fauna/Lebewesen/Vogelvogel/Wesen/Tier/Organismus/Vogel
Fuchs	Wirbeltier/Kreatur/Sein/Fauna/Lebewesen/Fleischfresser/Säugetier/Tier/Eckzahn/Organismus
Gans	Wirbeltier/Hausgeflügel/Kreatur/Fauna/Wasservögel/Lebewesen/Geflügel/Wesen/Tier/Organismus/Vogel/Schädel
Geier	Wirbeltier//Kreatur/Raubvogel/Fauna/Lebewesen/Wesen/Tier/Organismus/Vogel/Schädel
Gibbon	Wirbeltier/Kreatur/Fauna/Säugetier/Wesen/Tier/Affe/Animationswesen/Organismus/Primat
Gorilla	Wirbeltier/Kreatur/Fauna/Hominide/Lebewesen/Säugetier/Wesen/Tier/Affe/Organismus/Primat
Habicht	Wirbeltier/Kreatur/Raubvogel/Fauna/Lebewesen/Wesen/Tier/Organismus/Vogel/Schädel
Hirsche	Wirbeltier/Wiederkäuer/Kreatur/Fauna/Lebewesen/Säugetier/Wesen/Tier/Organismus/Huftier/Rinder
Hund	Wirbeltier/Kreatur/Sein/Fauna/Fleischfresser/Säugetier/Tier/Eckzahn/Organismus
Hühner	Wirbeltier/Vögel/Hausgeflügel/Kreatur/Fauna/Lebewesen/Geflügel/Wesen/Tier/Organismus/Vogel
Jaguar	Fauna/Fleischfresser/Säugetier/Tier/Katze/Organismus
Kakerlake	Wirbelloses/Fauna/Sein/Lebewesen/Tier/Organismus/Körperlichkeit/Insekt
Katze	Fauna/Fleischfresser/Säugetier/Tier/Organismus
Klapperschlange	Schlange/Reptil
Kobra	Schlange/Reptil
Kojote	Wirbeltier/Kreatur/Sein/Fauna/Fleischfresser/Säugetier/Tier/Organismus/Hund
Kuh	Wirbeltier/Wiederkäuer/Kreatur/Fauna/Lebewesen/Säugetier/Wesen/Tier/Vieh/Organismus/Huftier
Käfer	Wirbelloses/Fauna/Lebewesen/Wesen/Tier/Organismus/Insekt
Leopard	Fauna/Fleischfresser/Säugetier/Tier/Katze/Organismus/Kausalagent
Löwe	Fauna/Fleischfresser/Säugetier/Tier/Katze/Organismus
Mamba	Schlange/Reptil
Maus	Wirbeltier/Kreatur/Fauna/Säugetier/Tier/Organismus/Nagetier
Mensch	Wirbeltier/Kreatur/Fauna/Hominide/Säugetier/Wesen/Tier/Affe/Organismus/Primat
Orang-Utan	Wirbeltier/Kreatur/Fauna/Hominide/Säugetier/Wesen/Tier/Affe/Organismus/Primat
Pony	Wirbeltier/Kreatur/Fauna/Lebewesen/Säugetier/Tier/Organismus/Pferd
Schakal	Wirbeltier/Kreatur/Sein/Fauna/Lebewesen/Fleischfresser/Säugetier/Tier/Eckzahn/Organismus
Schimpanse	Wirbeltier/Kreatur/Fauna/Hominide/Lebewesen/Säugetier/Wesen/Tier/Affe/Organismus/Primat
Schmetterling	Kreatur/Fauna/Lebewesen/Tier/Organismus/Insekt
Stachelschwein	Wirbeltier/Kreatur/Fauna/Säugetier/Tier/Organismus/Nagetier
Stegosaurus	/Archosaurier/Reptil/Dinosaurier
Tiger	Fauna/Fleischfresser/Säugetier/Tier/Katze/Organismus
Triceratops	Archosaurier/Reptil/Dinosaurier
Truthahn	Wirbeltier/Hausgeflügel/Kreatur/Fauna/Lebewesen/Geflügel/Wesen/Tier/Organismus/Vogel
Tyrannosaurus	Theropod/Archosaurier/Reptil/Dinosaurier
Velociraptor	Reptil/Dinosaurier
Viper	Schlange/Reptil
Wachtel	Wirbeltier/Wildgeflügel/Kreatur/Fauna/Lebewesen/Geflügel/Wesen/Tier/Organismus/Vogel
Wolf	Wirbeltier/Kreatur/Sein/Fauna/Fleischfresser/Säugetier/Tier/Eckzahn/Organismus
Ziege	Wirbeltier/Fauna/Säugetier/Wesen/Tier/Organismus/Huftier