Alge	Zellmembran/Zellwand/Chloroplast/Zytoplasma/Flagellum/Nukleolus/Nukleus/Stärkevakuol
Atom	Elektron/Neutron/Proton
Auto	Gas/Aufhängungssystem/Stoßdämpfer/Hupe/Türschloss/Autofenster/Motor/Kofferraum/Handschuh/Hoch/Sonnenscheindach/Kotflügel/Federung/Tür/Luft/Scharnier/Rücken/Auspuffrohr/Pedal/Anti-Pendel/Einlasskrümmer/Gaspedal/Dritter/Armlehne/Stabilisatorstange/Stoßstange/Auspuff/Zapfen/Puffer/Gepäck/Luftbeutel/Stabilisator/Autozubehör/Motorhorn/Licht/Hooter/Zubehör/Benzinmotor/Automobiltrunk/Flosse/Heck/Dach/Sicherheitsgurt/Rückenlehne/Auto-Tür/Kühlergrill/Abteil/Tasche/Pistole/Rückwärtsgang/Schiebedach/Hupenknopf/Auspuffkrümmer/Bar/Kühler/Sitz/Heckflosse/Flügel/Spiegel/Auspuffsystem/Kissen/Getriebe/Benzin/Kopfstütze/Motorhaube/Autohorn/Schalldämpfer/Gepäckraum/Autositz/Trittbrett/Auto-Motor/Diele/Heckfenster/Fenster
Blume	Blütenblätter/Eierstock/Kelch/Chlamys/Kelchblatt/Stempel/Blütenblatt/Fruchtblatt/Perigone/Plazenta/Narbe/Gynostegium/Perigonium/Staubbeutel/Blütenhülle/Krone/Staubblatt/Korona/Stil/Blatt/Umschlag
Burg	Wassergraben/Bergfried/Verlies/Turm/Tor/Donjon
Bus	Dach/Leiter/Fahrer/Sitze/Fenster
Byte	Bit
Bürste	Griff/Stiel/Handgriff/Kopf/Borste/Schaft
Datei	Name/Namenerweiterung
Euro	Cent
Fenster	Fensterscheibe/Rahmen/Fensterschloss/Glasrahmen/Fensterbank/Scheibe/Flügel/Glas/Schloss/Gehäuse/Verkleidung/Flügelschloss/Befestigungselement/Fensterflügel/Fensterglas/Fensterrahmen/Pfosten
Film	Aufnahme/Filmmaterial/Szene/Bildunterschrift/Untertitel/Credits/Sequenz/Episode/Kredit
Flughafen	Fugzeug/Landebahn/Flughafenterminal/Kontrollturm/Hangar/Lounge/Rollweg/Terminal
Funk	Funkempfänger/Detektor/Empfänger/Verstärker/Empfangsgerät/Funkgerät/Funk/Tuner/Empfang/Funksender/Set/Demodulator/Sender
Gebärmutter	Eileiter/Plazenta/Gebärmutterhals/Gebärmutterschlauch/Myometrium/Endometrium/Caul/Uterusarterie/Embryonalmembran/Schleier
Gedicht	Raureif/Prosodie/Gesang/Reim/Linie/Strophe/Vers
Gefängnis	Zellenblock/Polizei/Gefängniszelle/Zelle/Wache
Gigabit	kbit/Megabit/mb/Kilobit/mbit/kb
Gitarre	Deck/Bünde/Bund/Heringe/Griffbrett/Saite/Saiten
Gramm	Obolus/mcg/Karat/Mikrogramm/Nanogramm/mg/dg/Dezigramm/ng/Korn/Milligramm
Hafen	Landestufe/Ankerplatz/Anlage/Docking-Anlage/Landeplatz/Docking/Landung/Dock/Dockage
Hemd	Hemdsärmel/Hemdknopf/Ärmel/Tasche/Dickie/Dickey/Kragen/Hemdfront/Knöpfe/Hemdschwanz/Dicky/Knopf
Hirsch	scut/Geweih/Flagge/Widerrist
Kamm	Zähne/Zahn/Griff/Schaft
Katze	Schwanz/Zähne/Pfote/Schnurrhaare/Pfoten/Fell/Augen/Krallen/Rücken
Kirche	Querschiff/Kreuz/Leinwand/Turm/Kreuzbild/Kirchenschiff/Heiligtum/Amen/Apsis/Sakristei/Presbyterium/Seite/Ecke/Chor/Kirchturm/Altar/Narthex/Seitentapel/Bema/Kapelle
Klavier	Soundboard/Tastatur/Soft/Griffbrett/Hammer/laut/Key/Board/Sounding/Action/Sustaining/Pedal
Kleid	Plastron/Ärmel/Mieder/Reißverschluss/Taille/Gürtel/Verschluss/Saum/Ausschnitt/Rutsche
Klimaanlage	Gebläse/Kompressor/Verflüssigerregister/Bedienfeld/Kühlregister/Verdampferregister/Expansionsventil/Ventilator/Motor/Temperaturfühler/Thermostat
Liter	mil/Kubikzentimeter/ml/Kubikmillimeter/Zentiliter/Milliliter/cl/Deziliter/cm³/dl
Pistole	Lauf/Lager/Gunstock/Aktion/Mechanismus/Abzug/Hammer/Fang/Hahn/Sucher/Patrone/Magazin/Clip/Halter/Kammer/Visier/Sicherheit/Gunlock/Entferner/Auszieher/Schlüssel/Schloss/Auswerfer/Mündung
Pub	Ginmill/Bar/Salon/Schankraum
Rechtschreibung	Interpunktion/Interpunktionszeichen/Silbentrennung/Rechtschreibung/Wortteilung
Schmuck	Silber/Draht/Juwel/Perlen/Platina/Gold/Metall/Perle/Stein/Edelstein
Schreibmaschine	Umschalt/Multifunktionsleiste/Leertaste/Tastatur/Umschalttaste/Schreibmaschinenwagen/Rücktaste/Wagen/Aktion/Aktionsmechanismus/Schreibmaschinentaste/Rückspacer/Taste/Tabulatorschlüssel/Tab
Schwert	Knauf/Schneidkante/Griff/Stärke/Spitze/Klinge/Foible/Helve/Knopf/Messerkante
Stativ	Ständer/Bein
Stuhl	Kopfstütze/Auflage/Armlehne/Beine/Sitz/Armlehnen/Bein/Rücken/Polster/Rückenlehne
Tag	Nanosekunde/Pikosekunde/Tageslicht/Hoch/mittag/viertel/Abend/Mittag/Mikrosekunde/Mitternacht/hoch/Viertelstunde/Morgen/Sekunde/millisekunde/gerade/zwölf/Zeit/morgens/Nacht/attosekunde/nacht/mittags/ms/Minute/mittwoch/Vormittag/Femtosekunde/zweitens/Stunde/zeit/nachmittags/Tag/Ereignis/Dunkel
Teekanne	Teefilter/Filter/Bauch/Griff/Deckel/Auslauf/Boden/Körper/Knopf
Telefon	Telefonhörer/Telefonempfänger/Kabel/Mundstück/Display/Bildschirm/Zifferblatt
Tisch	Beine/Bein/Geschirr/Tischplatte
Tonne	Zentner/kg/Karat/decagram/Kilo/obolus/Myg/Getreide/mg/dg/ng/doppelzentner/Quintal/Milligramm/hg/dkg/Mikrogramm/g/Myriagramm/Kilogramm/mcg/Nanogramm/Gramm/hektogram/dekagram/Tag/Centner/Dezigramm
Torso	venter/Hinterdarm/Omphalos/Deltamuskel/Po/Derriere/Hinterteil/Pektus/Rücken/Mittelteil/Hintern/Brust/Bauchnabel/Wange/Acromion/Fanny/Achsel/Serratus/Brustbein/Seite/Lat/posterior/klein/Leiste/Tush/Heck/Keister/Schulterblatt/Bauch/Mediastinum/Sattel/Mitte/Taille/Sitz/Teres/Rumpf/Gladiolus/Manubrium/Arsch/Pectoralis/Lenden/Hinter/Fundament/Prat/Gesäß/Thorax/Nabel/tail/Brötchen/CAN/Gallenblase/Darm/Magen/Zwerchfell/Schulter
Torte	Beeren/Kruste/Käse/Zuckerguss/Apfel/Gebäck/Füllung/Glasur/Obst
Treppe	Treppenabsatz/Steigleitung/Stufe
Triebwag	Kissen/Stoßdämpfer/Aufhängung/Aufhängungssystem
Tür	Türschwelle/Türrahmen/Schwelle/Riegel/Türpfosten/Koffer/Türkoffer/Schloss/Gehäuse/Schlüsselloch/Scharnier/Becher
Vogel	Ritzel/vogel/gefieder/Fuß/Calamus/Syrinx/web/Wimpel/drüse/giblet/Innereien/Widerhaken/Geflügel/Kralle/hinterhand/oberschenkel/Putzen/auster/Schaft/wunschknochen/Füße/Schnabel/Alula/Federn/Flügel/Rumpf/Kruppe/Feder/neb/Schwanz/furcula/feder/schnabel/sac/Querlenker/Trommelstock
Wohnung	Toilette/Küche/Küchenzeile/Bad/Wohnzimmer/Zimmer/Duschraum/Speisekammer/Schlafzimmer