abeille	bourdonnement/vrombissement
agneau	bêlement
aigle	glatissement/trompètement
albatros	piaulement
baleine	chant
bouc	béguètement/bêlement/chevrotement
buffle	beuglement/mugissement/soufflement
buse	beuglement/mugissement/soufflement
bœuf	beuglement/meuglement/mugissement
canard	cancan/caquet/caquetage/nasillement/nasillonnement
cerf	brame
chacal	aboîment/jappage/jappement/piaulement
chameau	blatèrement
chat	miaou/miaulement/ronronnement
chauve-souris	grincement
cheval	hennissement/reniflement
chien	aboiement/glapissement/grognement/gémissement/hurlement/ouaf
chimpanzé	cri
chèvre	bêlement
cigale	bourdonnement
cigogne	claquetement/craquement/craquètement/glottorement
cochon	couinement/grognement/grouinement
coq	chant/cocorico/coquelinement/coqueriquement
coyote	hurlement
crapaud	croassement
girafe	bêlement/meuglement/mugissement
gorille	cri/grognement
guêpe	bourdonnement/vrombissement
hirondelle	gazouillement/tridulement/trissement/truissotement
hyène	rire
lapin	clapissement/couinement/glapissement
lion	grognement/rugissement
loup	hurlement
léopard	grognement/rugissement
marmotte	sifflement
mouton	bêlement
oiseau	chant/cui-cui/gazouillis/pépiement
ours	grognenement
pigeon	roucoulement
porc	crissement/grognement
rat	couinement
renard	glapissement/hurlement
sanglier	grognement/grommellement/nasillement/nasillonnement
serpent	sifflement
singe	bavardage/cri/hurlement
souris	chicotement/couinement
tigre	grognement/rugissement
zèbre	hennissement
âne	braiment
éléphant	baret/barrissement/barrit/barronnement
