brocoli	vert
café	brun/noir
canneberge	rose/rouge/violette
carotte	jaune/orange/rouge
cerise	jaune/noire/rouge
charbon	noir
chocolat	blanc/marron/noir
chou	blanc/rouge/vert
chou-fleur	blanc/jaune/jauneâtre/vert
ciel	bleu/gris
concombre	vert
corbeau	noir
crème	blanche
cygne	blanc/gris/noir
céleri	blanc/marron/vert
dent	blanc
dentifrice	blanc
feuille	jaune/rouge/verte
fourmi	brune/noire/rouge
grenouille	brune/grise/verte
herbe	verte
hématome	bleu/violet
lait	blanc
mer	bleue/grise/verte
myrtille	bleue/noire
neige	blanc
nuage	blanc/gris
papier	blanc/couleur
patate	brune
persil	vert
pivoine	blanche/rose/rouge/violette
poivre	jaune/noir/orange/rouge/vert
pomme	doré/jaune/orange/rouge
radis	blanc/noir/rose/rouge/vert
raisin	noir/rouge/vert/violet
rose	blanche/bleue/jaune/rose/rouge
rubis	rouge
réfrigérateur	argent/blanc/noir
sang	rouge
saphir	bleu
sel	blanc
soleil	jaune/or
sucre	blanc/brun
tableau	noir/vert
terreau	brun/foncé/noir
thé	blanc/brun/jaune/noir/rouge/vert
tomate	rouge
yaourt	blanc/rose
émeraude	vert
épinard	vert
