个子	小个子
事	小事
人	小人
人儿	小人儿
人物	小人物
伙伴	小伙伴
伙子	小伙子
儿子	小儿子
册子	小册子
动作	小动作
叔	小叔
口	小口
哥	小哥
哥儿们	小哥儿们
商品	小商品
商贩	小商贩
天鹅	小天鹅
妹	小妹
姐	小姐
姑娘	小姑娘
孩子	小孩子
家电	小家电
山	小山
岛	小岛
弟	小弟
手	小手
斑	小斑
河	小河
熊	小熊
狐	小狐
百货	小百货
窗	小窗
组长	小组长
老鼠	小老鼠
脚	小脚
腿	小腿
花	小花
草	小草
虫	小虫
袋	小袋
象	小象
雨	小雨
雪	小雪
马	小马
鸟	小鸟
鸡	小鸡
鹅	小鹅
鹰	小鹰
鹿	小鹿
黄鼠	小黄鼠