东京	日本
伊斯兰堡	巴基斯坦
伦敦	英国
伯恩	瑞士
内罗毕	肯尼亚
利马	秘鲁
北京	中国
华沙	波兰
台北	台湾
哈瓦那	古巴
哥本哈根	丹麦
喀布尔	阿富汗
圣地亚哥	智利
基辅	乌克兰
堪培拉	澳大利亚
大马士革	叙利亚
奥斯陆	挪威
安卡拉	土耳其
安曼	约旦
巴格达	伊拉克
巴黎	法国
布加勒斯特	罗马尼亚
布达佩斯	匈牙利
布鲁塞尔	比利时
开罗	埃及
德黑兰	伊朗
斯德哥尔摩	瑞典
曼谷	泰国
柏林	德国
河内	越南
渥太华	加拿大
科纳克里	几内亚
第比利斯	格鲁吉亚
维也纳	奥地利
罗马	意大利
苏菲亚	保加利亚
莫斯科	俄国
萨格勒布	克罗地亚
贝尔格莱德	塞尔维亚
贝鲁特	黎巴嫩
赫尔辛基	芬兰
达卡	孟加拉国
都柏林	爱尔兰
里斯本	葡萄牙
金斯顿	牙买加
阿布贾	尼日利亚
雅典	希腊
雅加达	印度尼西亚
马尼拉	菲律宾
马德里	西班牙