Arm	armlos
Atem	atemlos
Ausdruck	ausdruckslos
Ausnahme	ausnahmslos
Aussicht	aussichtslos
Bein	beinlos
Beispiel	beispiellos
Belang	belanglos
Bewegung	bewegungslos
Chance	chancenlos
Charakter	charakterlos
Einfall	einfallslos
Einfluss	einflusslos
Eltern	elternlos
Emotion	emotionslos
Erbe	erblos
Erfolg	erfolglos
Fehler	fehlerlos
Fenster	fensterlos
Fleisch	fleischlos
Freud	freudlos
Gedanken	gedankenlos
Gefühl	gefühllos
Geld	geldlos
Geruch	geruchlos
Geschlecht	geschlechtslos
Gesetz	gesetzlos
Gott	gottlos
Haare	haarlos
Herz	herzlos
Kind	kinderlos
Kohlenstoff	kohlenstofflos
Leben	leblos
Leidenschaft	leidenschaftslos
Mittel	mittellos
Mühe	mühelos
Reibung	reibungslos
Rücksicht	rücksichtslos
Schuld	schuldlos
Seele	seelenlos
Sensor	sensorlos
Sprache	sprachlos
Takt	taktlos
Talent	talentlos
Tor	torlos
Weg	weglos
Wehr	wehrlos
Witz	witzlos
Zahn	zahnlos
Ärmel	ärmellos