airco	blower/compressor/condensorbatterij/bedieningspaneel/koelspiraal/verdamperspiraal/expansieklep/ventilator/motor/temperatuurvoeler/thermostaat
algen	celmembraan/celwand/chloroplast/cytoplasma/flagellum/nucleolus/kern/zetmeelvacuole
appartement	woonkamer/slaapkamer/toilet/bijkeuken/kamer/doucheruimte/keuken/badkamer/kitchenette
auto	toeter/hoofdsteun/achteruitversnelling/vleugel/achter/bumper/schuifdak/stabilisatorstang/armsteun/rugleuning/geluiddemper/bagage/gas/kofferbak/schokdemper/uitlaatsysteem/deur/compartiment/claxonknop/airbag/tas/automotor/autodeur/bagageruimte/gang/radiator/versnellingsbak/grille/ophanging/hoog/autoaccessoires/uitlaatspruitstuk/autoruit/raam/motorkap/veiligheidsgordel/buffer/accessoires/kussen/gaspedaal/benzine/antislinger/bar/zonnedak/inlaatspruitstuk/autostoel/lucht/veersysteem/staartvin/spiegel/rug/deurslot/kraan/radiatorgrille/pistool/claxon/uitlaat/vin/handschoen/treeplank/licht/dak/benzinemotor/achterruit/motor/uitlaatpijp/spatborden/pedaal/stabilisator/stoel/scharnier
baarmoeder	embryonaal/baarmoederslagader/caul/eileider/placenta/myometrium/sluier/endometrium/baarmoederhals
bestand	naam/extensie
bloem	kroon/blad/placenta/eierstok/meeldraad/bloemblad/fruitblad/envelop/gynostegium/helmknop/bloemblaadjes/stijl/chlamys/kelk/kelkblaadjes/corona/stigma/perigone/blaadje/perigonium/stamper
borstel	haar/handvat/steel/kop
bus	ladder/stoelen/bestuurder/dak/raam
byte	bit
dag	ochtend/even/milliseconde/middag/woensdag/microseconde/dag/picoseconde/uur/tijd/avond/hoog/daglicht/twaalf/kwart/tweede/femtoseconde/minuut/evenement/middernacht/nanoseconde/nacht/donker/ms/attoseconde/seconde/kwartier/s
deur	slot/sleutelgat/deurstijl/behuizing/deurbehuizing/grendel/instaplijsten/koffer/instaplijst/scharnier/mok/deurframe/klink/drempel
donjon	kerker/gracht/poort/toren
euro	cent
film	beelden/aflevering/credits/bijschrift/scène/tegoed/opname/ondertitels/reeks
gedicht	rijm/prosodie/couplet/rijp/stanza/lijn/lied
gevangenis	cel/bewaker/gevangeniscel/celblok/politie
gigabit	kbit/kilobit/mb/megabit/mbit/kb
gitaar	snaar/fret/snaren/frets/toets/haringen/deck
gram	microgram/mcg/nanogram/carat/decigram/mg/milligram/dg/graan/ng/obolus
haven	verankeren/dok/aanlegsteiger/voorziening/aanlegplaats/verankering/aanlanding/aanmeren
herten	vlag/gewei/schild/schoft
jurk	sluiting/dia/zoom/lijfje/taille/plastron/rits/mouw/riem/hals
kam	handvat/tanden/steel/tand
kat	poot/poten/akkebaarden/vacht/klauwen/tanden/staart/ogen/rug
kerk	schip/zijkant/amen/koor/bema/hoek/dwarsschip/kerktoren/heiligdom/altaar/narthex/apsis/canvas/toren/kapel/zijpaneel/sacristie/pastorie/kruisbeeld/kruis
korrel	myg/dkg/hectogram/decagram/decagram/obolus/doppelzentner
liter	mil/ml/milliliter/centiliter/deciliter/cl/cm³/dl
luchthaven	vliegtuig/landingsbaan/luchtterminal/verkeerstoren/hangar/lounge/taxibaan/terminal
motorwagen	veersysteem/kussen/ophanging/schokdemper
piano	klinkend/zacht/toetsenbord/luid/sustaining/klankbord/toets/pedaal/bord/actie/hamer
pistool	clip/vangst/gunstock/lager/patroon/verwijderaar/vat/uitwerper/tijdschrift/pistoolvergrendeling/actie/mechanisme/trekker/kraan/sleutel/houder/zoeker/kamer/extractor/snuit/beveiliging/vizier/slot/hamer
pub	salon/taproom/ginmill/bar
radio	demodulator/set/radiozender/ontvanger/zender/detector/radio-ontvanger/tuner/ontvangst/radio/versterker
schrijfmachine	sleutel/shift/toetsenbord/tab-toets/lint/backspacer/tabblad/spatiebalk/schrijfmachinewagen/schrijfmachine-toets/actiemechanisme/actie/wagen/backspace
shirt	dickie/dicky/kraag/dickey/knoppen/mouw/knop/zak
sierade	zilver/goud/juweel/platina/edelsteen/parel/draad/metaal/parels/steen
statief	poot/stand
stoel	hoofdsteun/benen/armleuningen/pad/stoffering/zitting/rug/rugleuning/armleuning/been
taart	appel/bessen/korst/vulling/fruit/glazuur/gebak/kaas
tafel	servies/poot/blad/poten
telefoon	telefoonhoorn/scherm/mondstuk/wijzerplaat/hoorn/kabel/display
theepot	handvat/buik/body/deksel/filter/uitloop/theefilter/knop/bodem
ton	kg/microgram/karaat/kilogram/centner/dag/decigram/mg/dg/ng/metrische/kilo/milligram/g/honderdgewicht/myriagram/mcg/vijfde/granen/nanogram/hg/gram
torso	venter/schouder/buik/deltaspier/zijkant/heupen/schouderblad/oksel/middenrif/pectus/gladiolen/billen/romp/lat/prat/bil/can/thorax/tush/mediastinum/posterieur/middengedeelte/manubrium/acromion/darm/pit/lies/arsch/klein/galblaas/achtersteven/omphalos/taille/borstbeen/borst/teres/zadel/borstspier/rug/zit/lendenen/wang/navel/knot/achterlijf/serratus/derriere/midden/foundation/staart/kont
trap	trede/overloop/riser
venster	behuizing/slot/bevestigingselement/glasraam/vensterglas/ruit/glas/vensterbank/vleugelvergrendeling/raamkozijn/raamvergrendeling/raam/paal/bekleding/ruitleugel/frame
vogel	voet/vogel/veren/rondsel/syrinx/vleugel/web/weerhaak/draagarmen/oester/voeten/torso/verenkleed/veer/wimpel/drumstick/ingewand/klier/zak/snavel/gladstrijken/achterhand/gevogelte/alula/slachtafval/furcula/schacht/klauw/dij/calamus/staart/nevel/vorkbeen/kruis
woord	spelling/leestekens/afbreking/woordverdeling
zwaard	tip/foible/handvat/blad/sterkte/helve/meskant/snijkant/knop