benzina	carburante/idrocarburo/sostanza/composto/materiale
braccialetto	monile/fascia/manufatto/oggetto/entità/decorazione/ornamento
brioche	dolce/cibo/alimento/entità
camicia	vestito/abbigliamento/vestiario/prodotto/manufatto/oggetto
cartolina	corrispondenza/messaggio
collana	monile/ornamento/decorazione/manufatto/oggetto/entità
computer	dispositivo/macchina/manufatto/oggetto/entità
crostata	dessert/cibo/nutrimento/alimento/sostanza/entità/dolce
cucitrice	dispositivo/macchina/manufatto/oggetto/entità
deodorante	manufatto/oggetto/entità
diario	entità/libro/volume/manufatto/oggetto
divano	mobile/arredamento/manufatto/oggetto/entità
foto	immagine/rappresentazione/creazione/manufatto/oggetto/entità
frigo	prodotto/bene/manufatto/oggetto/entità
giacca	vestito/cappotto/abbigliamento/vestiario/prodotto/bene/manufatto/oggetto
gonna	vestito/abbigliamento/vestiario/prodotto/bene/manufatto/oggetto
hamburger	panino/snack/piatto/nutrimento/alimento/cibo/sostanza/entità/carne
jeans	pantaloni/abbigliamento/vestito/vestiario/prodotto/bene/manufatto/oggetto
lavastoviglie	apparecchio/macchina/entità/oggetto/prodotto/bene/manufatto
lavatrice	apparecchio/macchina/entità/oggetto/prodotto/bene/manufatto
limone	frutto/prodotto/cibo/entità
lozione	manufatto/oggetto/entità
maglietta	abbigliamento/vestito/vestiario/prodotto/bene/manufatto/oggetto
maglione	vestito/abbigliamento/vestiario/prodotto/bene/manufatto/oggetto
marciapiede	passerella/percorso/via/oggetto/entità
mascara	trucco/cosmetico/manufatto/oggetto/entità
mela	frutto/prodotto/cibo/entità
mensola	mobile/arredamento/manufatto/oggetto/entità
miscelatore	utensile/manufatto/oggetto/entità
pantaloni	manufatto/oggetto/entità/indumento/vestito/vestiario/prodotto/bene
pasticcino	cibo/dolce/alimento/sostanza/entità
pesca	frutto/prodotto/cibo/entità
polsino	fascia/manufatto/oggetto/entità
poltrona	sedia/mobile/arredamento/manufatto/oggetto/entità
pompelmo	frutto/prodotto/cibo/entità
profumo	manufatto/oggetto/entità
prugna	frutto/prodotto/cibo/entità
rossetto	trucco/cosmetico/manufatto/oggetto/entità
scrivania	mobile/tavolo/arredamento/manufatto/oggetto/entità
spazzolino	spazzola/manufatto/oggetto/entità
spilla	monile/ornamento/decorazione/manufatto/oggetto
spremiagrumi	utensile/entità/oggetto/manufatto
taccuino	entità/oggetto/libro
tazza	stoviglie/manufatto/oggetto/entità/contenitore/bicchiere
torta	dessert/cibo/nutrimento/alimento/sostanza/entità/dolce
tostapane	entità/oggetto/prodotto/bene/manufatto
tv	dispositivo/macchina/ricevitore/manufatto/oggetto/entità
vasca	contenitore/manufatto/unità/oggetto/entità
vaso	serbatoio/contenitore/manufatto/oggetto/entità
vestito	abbigliamento/vestiario/prodotto/bene/manufatto/oggetto
