abbondante	scarso/raro/magro/avaro/insufficiente/carente
asciutto	bagnato/irrorato/paludoso/melmoso/fangoso/molle/umido/gocciolante/acquoso
basso	alto/allampanato/longilineo/lungo/statuario
bello	brutto/sfigurato/grottesco/mostruoso/orrendo/ripugnante/imbarazzante
bianco	nero/scuro
caldo	gelido/freddo/frigido/fresco
capace	incapace/incompetente
chiaro	scuro
colorato	incolore/opaco/neutro/pallido/bianco/sbiancato/sbiadito/slavato/cupo/tetro
competente	incompetente
comune	raro/infrequente
consapevole	ignaro/incurante/inconscio/insensibile/inconsapevole/ignorante/indifferente
contento	triste/pensieroso/malinconico/tragico/tragicomico/deplorevole/angosciante/pietoso
cotto	crudo
deciso	esitante/indeciso/titubante/inconcludente/irresoluto
difficile	facile
disposto	indisposto
dolce	acido/acerbo/stringente/inacidito/acetoso/amaro
economico	costoso/caro/prezioso
energico	letargico/stordito/svogliato/pigro
familiare	sconosciuto/ignaro
gassoso	solido/liquido
generoso	avaro/parsimonioso/tirchio
giovane	vecchio/anziano/senescente/antico/centenario/senile/emerito/novantenne/ottuagenario
grande	piccolo/atomico/subatomico/minuto/lillipuziano/nano/minuto/minuscolo/gnomico/infinitesimale/microscopico/micro/tascabile/sottomisura/sottotaglia
grasso	sottile/magro/anoressico/emaciato/scarno/scheletrico/allampanato/esile/ossuto/ossuto/sottopeso/rimpicciolito/secco/leggero
gustoso	insapore/insipido
interessante	noioso/fastidioso/narcotico/soporifero/prosaico
introverso	estroverso/socievole
largo	stretto/ridotto/ristretto/magro/sottile
lento	veloce/rapido
luminoso	pallido/incolore/opaco/neutro/sbiancato/sbiadito/slavato/cupo/tetro/ingrigito
lungo	breve/abbreviato/troncato/fugace/momentaneo
nervoso	calmo/tranquillo/placido/indolente
normale	alterato/aberrante/deviato/anormale/anomalo/atipico/irregolare/inusuale/eccezionale/folle/innaturale
organizzato	disorganizzato/scoordinato
pallido	abbronzato
pericoloso	sicuro/innocuo
piegare	irrigidire/raddrizzare
pieno	vacuo/vuoto
pigrizia	attività/operosità/attivismo/fervore
pulito	sporco/impuro/insozzato/sporcato/zozzo/sgangherato/volgare/unto/grasso/pessimo/logoro/macchiato
ricco	povero/impoverito/bisognoso/squattrinato
riluttante	docile/ubbidiente/arrendevole/remissivo
rumoroso	silenzioso/muto
sano	pazzo/pazzoide/folle
semplice	difficile/complicato
sincero	ipocrita/falso/disonesto/disonorevole
stretto	largo
vicino	distante/remoto/lontano