不幸	悲剧/痛苦/严重/差/可怕/灾难性
乐趣	爱情/关心/激情
伤心	沮丧/绝望/忧郁
信	狂热/热情
创意	独创性/发明性/创新
包	盒子
可口	美味/好吃
合理	逻辑/连贯
同质	统一
哭	尖叫/呐喊
困惑	迷失/怀疑/绝望/迷惑/震惊
坏	残暴/可憎/可怕/痛苦
姑娘	少女
害怕	僵硬/石化/惊慌失措
家	城堡/堡垒
对象	伙伴/伴侣
小憩	睡觉/瞌睡
小马	马
岩	结石/石头
布	织物/材料/纺织
恶棍	坏人/小偷
感冒	肺炎
愤怒	生气/震惊/冒泡
救命	支持
新	现代/最近
无聊	呆板/单调/烦人
时间	时刻/时期
晚餐	宴会
暴发	爆炸/爆燃
有趣	兴奋/狂喜
样式	方式
海	海洋
清单	列表
湖	海洋/海
湿	浸泡/潮湿/饱和
热	闷热
爱	崇拜/迷恋
猴	大猩猩
电话	手机
疼痛	折磨/死亡
相反	不利/讨厌/不适/厌恶/反对
相同	一样/难以区分
细雨	雨/洪水
讨厌	鄙视/轻视
词汇	词典/字典
诚实	真诚/天真/真实
部分	零件/组件
重点	重要性
错	错误
问	恳求/祈祷/拜托/坚持