丑	丑陋
乏	疲乏
俊	俊秀
假	虚假
傲	骄傲
净	干净
刚	刚强
勇	勇敢
古	古老
呆	呆笨
哀	悲哀
娇	娇气
富	富裕
强	强大
急	紧急
怪	奇怪
恶	凶恶
惝	惝恍
惨	悲惨
愧	惭愧
慌	慌张
挤	拥挤
敞	宽敞
暴	暴躁
毒	毒辣
沉	沉重
浑	浑浊
浮	轻浮
淡	清淡
深	深厚
满	充满
潮	潮湿
烈	强烈
烦	厌烦
痴	痴呆
瘪	干瘪
笨	愚笨
粗	粗糙
繁	繁杂
美	美丽
肥	肥胖
脆	清脆
良	良好
苦	痛苦
蠢	蠢笨
贱	下贱
闷	憋闷
阔	阔绰
饱	饱满
黑	黑暗