丰富	差/稀/小气/不足
亮	黑/深/暗/黑暗
伟大	小/原子/亚原子/纳米/微小/微观/微型
低	高/苗条/长
便宜	贵/珍贵
健康	疯狂/怪胎
充分	真空
内向	外向
决定	犹豫不决
危险	安全/无害
可口	无味
合格	无能
嘈杂	静音
大	小/微
宽	窄
常见	罕见
干燥	湿式/浑浊/湿润/滴落/水性
年轻	老/百年/老年/退休
快乐	悲伤/悲剧/不幸/痛苦/可怜
愿意	不适
慢	快
慷慨	节俭/吝啬
折叠	拉直
明确	黑暗
有色	无色/浅色/漂白/褪色/深色/暗淡
有趣	无聊/烦
有钱	贫穷/一文不值/穷
正常	改变/荒谬/异常/不规则/独特/疯狂
气态	固体/液体
清洁	污垢/弄脏/肮脏/油脂/不良/沾污
热	冷/凉
煮	生
熟	生
熟悉	未知
熟练	无能
甜	酸/苦/醋
白色	黑色/深色
真诚	伪君子/虚假
窄	宽
简单	困难/复杂
精力	无精打采/呆滞
紧张	安静/平静/懒惰
美丽	怪诞/可怕/尴尬/丑/奇怪
胖	瘦
能够	无能
苍白	黑晒
认真	粗心/无意识/无知/漠不关心
近	远
长	短
难	简单/容易